Tanggal,Kasus Harian,Total kasus,Kasus aktif,% kasus aktif,Sembuh,Tingkat kesembuhan (seluruh kasus),Tingkat kesembuhan (closed cases),Meninggal Dunia,Tingkat kematian (seluruh kasus),Tingkat kematian (closed cases),Suspek aktif,Jumlah orang diperiksa,Negatif,Spesimen
2-Nov,2618,415402,55792,13.43%,345566,83.19%,96.09%,14044,3.38%,3.91%,"59,500",2919560,2504158,26661
3-Nov,2973,418375,54732,13.08%,349497,83.54%,96.11%,14146,3.38%,3.89%,"56,039",2941778,2523403,29928
4-Nov,3356,421731,54190,12.85%,353282,83.77%,96.12%,14259,3.38%,3.88%,"56,967",2969883,2548152,40979
5-Nov,4065,425796,54306,12.75%,357142,83.88%,96.14%,14348,3.37%,3.86%,"55,943",3001189,2575393,39581
6-Nov,3778,429574,54427,12.67%,360705,83.97%,96.15%,14442,3.36%,3.85%,"56,663",3030661,2601087,38091
7-Nov,4262,433836,54879,12.65%,364417,84.00%,96.16%,14540,3.35%,3.84%,"56,461",3059777,2625941,38249
8-Nov,3880,437716,54804,12.52%,368298,84.14%,96.18%,14614,3.34%,3.82%,"57,043",3080718,2643002,35588
9-Nov,2853,440569,53614,12.17%,372266,84.50%,96.20%,14689,3.33%,3.80%,"57,925",3105465,2664896,34365
10-Nov,3779,444348,53846,12.12%,375741,84.56%,96.22%,14761,3.32%,3.78%,"55,560",3137485,2693137,33063
11-Nov,3770,448118,54300,12.12%,378982,84.57%,96.23%,14836,3.31%,3.77%,"55,982",3175096,2726978,39341
12-Nov,4173,452291,55274,12.22%,382084,84.48%,96.24%,14933,3.30%,3.76%,"56,868",3211592,2759301,42165
13-Nov,5444,457735,57604,12.58%,385094,84.13%,96.24%,15037,3.29%,3.76%,"58,896",3249484,2791749,42333
14-Nov,5272,463007,59765,12.91%,388094,83.82%,96.24%,15148,3.27%,3.76%,"61,975",3288194,2825187,41336
15-Nov,4106,467113,59911,12.83%,391991,83.92%,96.26%,15211,3.26%,3.74%,"63,380",3313590,2846477,32861
16-Nov,3535,470648,59909,12.73%,395443,84.02%,96.28%,15296,3.25%,3.72%,"63,683",3341160,2870512,34639
17-Nov,3807,474455,60426,12.74%,398636,84.02%,96.28%,15393,3.24%,3.72%,"64,928",3377716,2903261,39772
18-Nov,4265,478720,60870,12.72%,402347,84.05%,96.29%,15503,3.24%,3.71%,"64,430",3415613,2936893,41942
19-Nov,4798,483518,61306,12.68%,406612,84.09%,96.31%,15600,3.23%,3.69%,"63,546",3456835,2973317,47630
20-Nov,4792,488310,62080,12.71%,410552,84.08%,96.32%,15678,3.21%,3.68%,"63,074",3496039,3007729,41955
21-Nov,4998,493308,63579,12.89%,413955,83.91%,96.33%,15774,3.20%,3.67%,"64,317",3526607,3033299,43122
22-Nov,4360,497668,63596,12.78%,418188,84.03%,96.34%,15884,3.19%,3.66%,"64,502",3553142,3055474,35989
23-Nov,4442,502110,63722,12.69%,422386,84.12%,96.35%,16002,3.19%,3.65%,"65,279",3580476,3078366,40083
24-Nov,4192,506302,64878,12.81%,425313,84.00%,96.35%,16111,3.18%,3.65%,"64,414",3608244,3101942,39971
25-Nov,5534,511836,65804,12.86%,429807,83.97%,96.36%,16225,3.17%,3.64%,"65,438",3651964,3140128,45330
26-Nov,4917,516753,66752,12.92%,433649,83.92%,96.37%,16352,3.16%,3.63%,"66,685",3690126,3173373,51471
27-Nov,5828,522581,68604,13.13%,437456,83.71%,96.36%,16521,3.16%,3.64%,"67,836",3729561,3206980,48823
28-Nov,5418,527999,69370,13.14%,441983,83.71%,96.37%,16646,3.15%,3.63%,"68,606",3766860,3238861,46574
29-Nov,6267,534266,71658,13.41%,445793,83.44%,96.37%,16815,3.15%,3.63%,"70,792",3797881,3263615,42903
30-Nov,4617,538883,71420,13.25%,450518,83.60%,96.38%,16945,3.14%,3.62%,"72,786",3827720,3288837,40055
1-Dec,5092,543975,72015,13.24%,454879,83.62%,96.38%,17081,3.14%,3.62%,"71,286",3865412,3321437,51232
2-Dec,5533,549508,73429,13.36%,458880,83.51%,96.39%,17199,3.13%,3.61%,"71,074",3907273,3357765,58245
3-Dec,8369,557877,77969,13.98%,462553,82.91%,96.38%,17355,3.11%,3.62%,"69,027",3952752,3394875,62397
4-Dec,5803,563680,80023,14.20%,466178,82.70%,96.39%,17479,3.10%,3.61%,"69,016",3992487,3428807,59365
5-Dec,6027,569707,81669,14.34%,470449,82.58%,96.40%,17589,3.09%,3.60%,"69,926",4029428,3459721,54922
6-Dec,6089,575796,83285,14.46%,474771,82.45%,96.40%,17740,3.08%,3.60%,"70,091",4058033,3482237,50634
7-Dec,5754,581550,84481,14.53%,479202,82.40%,96.41%,17867,3.07%,3.59%,"72,986",4079605,3498055,26873
8-Dec,5292,586842,85345,14.54%,483497,82.39%,96.41%,18000,3.07%,3.59%,"70,450",4113090,3526248,52819
9-Dec,6058,592900,87284,14.72%,487445,82.21%,96.41%,18171,3.06%,3.59%,"69,879",4143604,3550704,56034
10-Dec,6033,598933,88622,14.80%,491975,82.14%,96.41%,18336,3.06%,3.59%,"66,463",4176266,3577333,49603
11-Dec,6310,605243,89846,14.84%,496886,82.10%,96.41%,18511,3.06%,3.59%,"64,845",4216052,3610809,54072
12-Dec,6388,611631,91602,14.98%,501376,81.97%,96.41%,18653,3.05%,3.59%,"62,224",4253821,3642190,59388
13-Dec,6189,617820,93165,15.08%,505836,81.87%,96.41%,18819,3.05%,3.59%,"63,598",4279168,3661348,51048
14-Dec,5489,623309,93396,14.98%,510957,81.97%,96.42%,18956,3.04%,3.58%,"64,067",4308544,3685235,42006
15-Dec,6120,629429,93662,14.88%,516656,82.08%,96.43%,19111,3.04%,3.57%,"65,666",4347393,3717964,60700
16-Dec,6725,636154,94922,14.92%,521984,82.05%,96.44%,19248,3.03%,3.56%,"62,364",4383985,3747831,61291
17-Dec,7354,643508,97139,15.10%,526979,81.89%,96.45%,19390,3.01%,3.55%,"62,250",4427446,3783938,60629
18-Dec,6689,650197,98688,15.18%,531995,81.82%,96.46%,19514,3.00%,3.54%,"62,717",4465960,3815763,67678
19-Dec,7751,657948,102029,15.51%,536260,81.50%,96.46%,19659,2.99%,3.54%,"64,071",4507874,3849926,63768
20-Dec,6982,664930,103239,15.53%,541811,81.48%,96.46%,19880,2.99%,3.54%,"66,702",4536711,3871781,48134
21-Dec,6848,671778,104809,15.60%,546884,81.41%,96.46%,20085,2.99%,3.54%,"67,509",4561464,3889686,37445
22-Dec,6347,678125,105146,15.51%,552722,81.51%,96.46%,20257,2.99%,3.54%,"69,343",4592232,3914107,49806
23-Dec,7514,685639,106528,15.54%,558703,81.49%,96.48%,20408,2.98%,3.52%,"66,914",4625786,3940147,52672
24-Dec,7199,692838,108269,15.63%,563980,81.40%,96.48%,20589,2.97%,3.52%,"68,219",4665868,3973030,61068
25-Dec,7259,700097,108946,15.56%,570304,81.46%,96.47%,20847,2.98%,3.53%,"67,464",4700999,4000902,50393
26-Dec,6740,706837,109150,15.44%,576693,81.59%,96.49%,20994,2.97%,3.51%,"68,061",4732231,4025394,44581
27-Dec,6528,713365,108452,15.20%,583676,81.82%,96.49%,21237,2.98%,3.51%,"69,325",4761656,4048291,41963
28-Dec,5854,719219,107789,14.99%,589978,82.03%,96.49%,21452,2.98%,3.51%,"69,156",4788286,4069067,34796
29-Dec,7903,727122,108636,14.94%,596783,82.07%,96.49%,21703,2.98%,3.51%,"68,181",4831091,4103969,65143
30-Dec,8002,735124,109439,14.89%,603741,82.13%,96.49%,21944,2.99%,3.51%,"67,615",4875480,4140356,72922
31-Dec,8074,743198,109963,14.80%,611097,82.23%,96.50%,22138,2.98%,3.50%,"68,316",4912745,4169547,57800
1-Jan,8072,751270,111005,14.78%,617936,82.25%,96.51%,22329,2.97%,3.49%,"68,418",4940146,4188876,40785
2-Jan,7203,758473,110400,14.56%,625518,82.47%,96.52%,22555,2.97%,3.48%,"69,619",4964525,4206052,33530
3-Jan,6877,765350,110679,14.46%,631937,82.57%,96.53%,22734,2.97%,3.47%,"72,027",4992303,4226953,41503
4-Jan,6753,772103,110089,14.26%,639103,82.77%,96.54%,22911,2.97%,3.46%,"72,380",5022974,4250871,45868
5-Jan,7445,779548,110693,14.20%,645746,82.84%,96.54%,23109,2.96%,3.46%,"70,201",5061283,4281735,60520
6-Jan,8854,788402,112593,14.28%,652513,82.76%,96.55%,23296,2.95%,3.45%,"70,029",5106017,4317615,67908
7-Jan,9321,797723,114766,14.39%,659437,82.66%,96.56%,23520,2.95%,3.44%,"68,753",5150808,4353085,68019
8-Jan,10617,808340,117704,14.56%,666883,82.50%,96.56%,23753,2.94%,3.44%,"69,121",5193413,4385073,66619
9-Jan,10046,818386,120928,14.78%,673511,82.30%,96.57%,23947,2.93%,3.43%,"69,865",5232921,4414535,57058
10-Jan,9640,828026,122873,14.84%,681024,82.25%,96.58%,24129,2.91%,3.42%,"70,381",5264664,4436638,46025
11-Jan,8692,836718,123636,14.78%,688739,82.31%,96.59%,24343,2.91%,3.41%,"68,572",5292612,4455894,38061
12-Jan,10047,846765,126313,14.92%,695807,82.17%,96.58%,24645,2.91%,3.42%,"54,827",5333160,4486395,70309
13-Jan,11278,858043,129628,15.11%,703464,81.98%,96.57%,24951,2.91%,3.43%,"59,667",5380137,4522094,71689
14-Jan,11557,869600,133149,15.31%,711205,81.79%,96.57%,25246,2.90%,3.43%,"64,032",5426234,4556634,70376
15-Jan,12818,882418,138238,15.67%,718696,81.45%,96.58%,25484,2.89%,3.42%,"66,573",5475700,4593282,72957
16-Jan,14224,896642,143517,16.01%,727358,81.12%,96.58%,25767,2.87%,3.42%,"69,414",5521058,4624416,63300
17-Jan,11287,907929,145482,16.02%,736460,81.11%,96.59%,25987,2.86%,3.41%,"73,243",5555428,4647499,46138
18-Jan,9086,917015,144798,15.79%,745935,81.34%,96.60%,26282,2.87%,3.40%,"77,579",5587809,4670794,47488
19-Jan,10365,927380,146842,15.83%,753948,81.30%,96.59%,26590,2.87%,3.41%,"76,971",5631280,4703900,70634
20-Jan,12568,939948,149388,15.89%,763703,81.25%,96.60%,26857,2.86%,3.40%,"79,418",5675028,4735080,58805
21-Jan,11703,951651,151658,15.94%,772790,81.21%,96.60%,27203,2.86%,3.40%,"79,200",5718753,4767102,67454
22-Jan,13632,965283,156683,16.23%,781147,80.92%,96.60%,27453,2.84%,3.40%,"79,349",5770517,4805234,77942
23-Jan,12191,977474,158751,16.24%,791059,80.93%,96.62%,27664,2.83%,3.38%,"83,190",5813504,4836030,68343
24-Jan,11788,989262,162617,16.44%,798810,80.75%,96.63%,27835,2.81%,3.37%,"80,114",5848960,4859698,48002
25-Jan,9994,999256,161636,16.18%,809488,81.01%,96.64%,28132,2.82%,3.36%,"84,621",5883540,4884284,51906
26-Jan,13094,1012350,163526,16.15%,820356,81.03%,96.65%,28468,2.81%,3.35%,"82,156",5931637,4919287,75194
27-Jan,11948,1024298,164113,16.02%,831330,81.16%,96.65%,28855,2.82%,3.35%,"81,589",5978128,4953830,77788
28-Jan,13695,1037993,166540,16.04%,842122,81.13%,96.63%,29331,2.83%,3.37%,"82,676",6032242,4994249,87280
29-Jan,13802,1051795,170017,16.16%,852260,81.03%,96.65%,29518,2.81%,3.35%,"81,497",6084661,5032866,77300
30-Jan,14518,1066313,174083,16.33%,862502,80.89%,96.67%,29728,2.79%,3.33%,"74,985",6125290,5058977,70026
31-Jan,12001,1078314,175095,16.24%,873221,80.98%,96.68%,29998,2.78%,3.32%,"73,652",6158452,5080138,44688
1-Feb,10994,1089308,175349,16.10%,883682,81.12%,96.69%,30277,2.78%,3.31%,"76,343",6190345,5101037,48213
2-Feb,10379,1099687,172576,15.69%,896530,81.53%,96.70%,30581,2.78%,3.30%,"75,533",6233289,5133602,71702
3-Feb,11984,1111671,175236,15.76%,905665,81.47%,96.71%,30770,2.77%,3.29%,"76,657",6280182,5168511,74965
4-Feb,11434,1123105,174798,15.56%,917306,81.68%,96.73%,31001,2.76%,3.27%,"74,260",6322350,5199245,68744
5-Feb,11749,1134854,176672,15.57%,926980,81.68%,96.74%,31202,2.75%,3.26%,"77,704",6366581,5231727,76373
6-Feb,12156,1147010,176433,15.38%,939184,81.88%,96.77%,31393,2.74%,3.23%,"74,401",6414683,5267673,65167
7-Feb,10827,1157837,176291,15.23%,949990,82.05%,96.79%,31556,2.73%,3.21%,"76,029",6445583,5287746,41526
8-Feb,8242,1166079,171288,14.69%,963028,82.59%,96.81%,31763,2.72%,3.19%,"77,601",6473598,5307519,38661
9-Feb,8700,1174779,169351,14.42%,973452,82.86%,96.82%,31976,2.72%,3.18%,"77,086",6512126,5337347,67888
10-Feb,8776,1183555,168416,14.23%,982972,83.05%,96.83%,32167,2.72%,3.17%,"77,526",6553179,5369624,70312
11-Feb,8435,1191990,166492,13.97%,993117,83.32%,96.84%,32381,2.72%,3.16%,"76,911",6591580,5399590,71511
12-Feb,9869,1201859,165086,13.74%,1004117,83.55%,96.85%,32656,2.72%,3.15%,"76,505",6626984,5425125,53957
13-Feb,8844,1210703,161731,13.36%,1016036,83.92%,96.86%,32936,2.72%,3.14%,"79,653",6651873,5441170,37816
14-Feb,6765,1217468,159012,13.06%,1025273,84.21%,96.86%,33183,2.73%,3.14%,"86,456",6676123,5458655,35894
15-Feb,6462,1223930,158498,12.95%,1032065,84.32%,96.87%,33367,2.73%,3.13%,"88,669",6695764,5471834,26378
16-Feb,10029,1233959,160689,13.02%,1039674,84.26%,96.87%,33596,2.72%,3.13%,"86,960",6721920,5487961,28167
17-Feb,9687,1243646,162182,13.04%,1047676,84.24%,96.88%,33788,2.72%,3.12%,"83,916",6744670,5501024,28167
18-Feb,9039,1252685,160494,12.81%,1058222,84.48%,96.89%,33969,2.71%,3.11%,"82,444",6767226,5514541,44617
19-Feb,10614,1263299,160142,12.68%,1069005,84.62%,96.90%,34152,2.70%,3.10%,"80,504",6839040,5575741,88821
20-Feb,8054,1271353,158197,12.44%,1078840,84.86%,96.92%,34316,2.70%,3.08%,"79,395",6871210,5599857,69479
21-Feb,7300,1278653,157088,12.29%,1087076,85.02%,96.92%,34489,2.70%,3.08%,"77,424",6900519,5621866,42837
22-Feb,10180,1288833,157148,12.19%,1096994,85.12%,96.93%,34691,2.69%,3.07%,"81,037",6943792,5654959,46562
23-Feb,9775,1298608,158604,12.21%,1104990,85.09%,96.93%,35014,2.70%,3.07%,"78,616",6999368,5700760,65431
24-Feb,7533,1306141,158162,12.11%,1112725,85.19%,96.93%,35254,2.70%,3.07%,"77,512",7051844,5745703,73014
25-Feb,8493,1314634,157705,12.00%,1121411,85.30%,96.93%,35518,2.70%,3.07%,"77,293",7101863,5787229,69544
26-Feb,8232,1322866,158408,11.97%,1128672,85.32%,96.93%,35786,2.71%,3.07%,"75,822",7141629,5818763,63872
27-Feb,6208,1329074,157039,11.82%,1136054,85.48%,96.93%,35981,2.71%,3.07%,"78,746",7173023,5843949,55495
28-Feb,5560,1334634,155765,11.67%,1142703,85.62%,96.93%,36166,2.71%,3.07%,"71,668",7194252,5859618,35434
1-Mar,6680,1341314,153074,11.41%,1151915,85.88%,96.94%,36325,2.71%,3.06%,"73,434",7218157,5876843,35684
2-Mar,5712,1347026,149645,11.11%,1160863,86.18%,96.95%,36518,2.71%,3.05%,"73,977",7248147,5901121,33174
3-Mar,6808,1353834,147197,10.87%,1169916,86.42%,96.96%,36721,2.71%,3.04%,"69,631",7295814,5941980,80144
4-Mar,7264,1361098,147845,10.86%,1176356,86.43%,96.96%,36897,2.71%,3.04%,"67,095",7334310,5973212,63051
5-Mar,6971,1368069,148356,10.84%,1182687,86.45%,96.96%,37026,2.71%,3.04%,"66,546",7355608,5987539,36107
6-Mar,5767,1373836,147172,10.71%,1189510,86.58%,96.97%,37154,2.70%,3.03%,"66,525",7393492,6019656,43900
7-Mar,5826,1379662,147740,10.71%,1194656,86.59%,96.97%,37266,2.70%,3.03%,"67,659",7423376,6043714,43900
8-Mar,6894,1386556,145628,10.50%,1203381,86.79%,96.97%,37547,2.71%,3.03%,"64,914",7461213,6074657,50261
9-Mar,6389,1392945,144311,10.36%,1210877,86.93%,96.98%,37757,2.71%,3.02%,"65,480",7505175,6112230,67854
10-Mar,5633,1398578,144213,10.31%,1216433,86.98%,96.98%,37932,2.71%,3.02%,"63,128",7566800,6168222,93016
11-Mar,5144,1403722,141070,10.05%,1224603,87.24%,96.99%,38049,2.71%,3.01%,"61,523",7616505,6212783,65736
12-Mar,6412,1410134,140451,9.96%,1231454,87.33%,96.99%,38229,2.71%,3.01%,"62,883",7661573,6251439,56918
13-Mar,4607,1414741,138942,9.82%,1237470,87.47%,97.00%,38329,2.71%,3.00%,"61,103",7711729,6296988,76914
14-Mar,4714,1419455,137912,9.72%,1243117,87.58%,97.00%,38426,2.71%,3.00%,"62,804",7739831,6320376,37825
15-Mar,5589,1425044,136524,9.58%,1249947,87.71%,97.01%,38573,2.71%,2.99%,"63,957",7781333,6356289,47808
16-Mar,5414,1430458,134042,9.37%,1257663,87.92%,97.01%,38753,2.71%,2.99%,"60,415",7828397,6397939,75626
17-Mar,6825,1437283,131695,9.16%,1266673,88.13%,97.02%,38915,2.71%,2.98%,"59,610",7887149,6449866,75980
18-Mar,6570,1443853,131753,9.13%,1272958,88.16%,97.02%,39142,2.71%,2.98%,"59,666",7923092,6479239,75737
19-Mar,6279,1450132,131828,9.09%,1278965,88.20%,97.02%,39339,2.71%,2.98%,"59,564",7969055,6518923,73460
20-Mar,5656,1455788,131616,9.04%,1284725,88.25%,97.02%,39447,2.71%,2.98%,"58,236",8012722,6556934,69700
21-Mar,4396,1460184,129844,8.89%,1290790,88.40%,97.03%,39550,2.71%,2.97%,"59,992",8039026,6578842,41355
22-Mar,5744,1465928,128250,8.75%,1297967,88.54%,97.03%,39711,2.71%,2.97%,"41,674",8076608,6610680,43755
23-Mar,5297,1471225,126439,8.59%,1304921,88.70%,97.04%,39865,2.71%,2.96%,"44,848",8126733,6655508,77402
24-Mar,5227,1476452,123926,8.39%,1312543,88.90%,97.04%,39983,2.71%,2.96%,"46,685",8176251,6699799,72278
25-Mar,6107,1482559,125279,8.45%,1317199,88.85%,97.05%,40081,2.70%,2.95%,"48,914",8229683,6747124,81091
26-Mar,4982,1487541,124497,8.37%,1322878,88.93%,97.05%,40166,2.70%,2.95%,"52,528",8281302,6793761,71559
27-Mar,4461,1492002,124517,8.35%,1327121,88.95%,97.05%,40364,2.71%,2.95%,"54,980",8327183,6835181,67548
28-Mar,4083,1496085,124236,8.30%,1331400,88.99%,97.05%,40449,2.70%,2.95%,"57,858",8357821,6861736,42685
29-Mar,5008,1501093,123694,8.24%,1336818,89.06%,97.05%,40581,2.70%,2.95%,"59,473",8396863,6895770,46663
30-Mar,4682,1505775,122326,8.12%,1342695,89.17%,97.05%,40754,2.71%,2.95%,"60,671",8445150,6939375,76904
31-Mar,5937,1511712,122524,8.10%,1348330,89.19%,97.06%,40858,2.70%,2.94%,"62,210",8490684,6978972,71440
1-Apr,6142,1517854,121222,7.99%,1355578,89.31%,97.06%,41054,2.70%,2.94%,"62,623",8545630,7027776,72794
2-Apr,5325,1523179,121011,7.94%,1361017,89.35%,97.07%,41151,2.70%,2.93%,"63,251",8587036,7063857,56495
3-Apr,4345,1527524,120068,7.86%,1366214,89.44%,97.07%,41242,2.70%,2.93%,"62,489",8623081,7095557,40066
4-Apr,6731,1534255,116709,7.61%,1375877,89.68%,97.06%,41669,2.72%,2.94%,"62,290",8656962,7122707,36490
5-Apr,3712,1537967,114475,7.44%,1381677,89.84%,97.06%,41815,2.72%,2.94%,"61,133",8695309,7157342,44957
6-Apr,4549,1542516,114566,7.43%,1385973,89.85%,97.06%,41977,2.72%,2.94%,"61,242",8745068,7202552,78042
7-Apr,4860,1547376,113570,7.34%,1391742,89.94%,97.07%,42064,2.72%,2.93%,"59,524",8798525,7251149,77496
8-Apr,5504,1552880,111271,7.17%,1399382,90.12%,97.07%,42227,2.72%,2.93%,"58,214",8852778,7299898,73416
9-Apr,5265,1558145,110138,7.07%,1405659,90.21%,97.08%,42348,2.72%,2.92%,"59,453",8900958,7342813,72712
10-Apr,4723,1562868,111137,7.11%,1409288,90.17%,97.08%,42443,2.72%,2.92%,"59,139",8944665,7381797,64091
11-Apr,4127,1566995,109958,7.02%,1414507,90.27%,97.08%,42530,2.71%,2.92%,"58,965",8975583,7408588,42106
12-Apr,4829,1571824,109372,6.96%,1419796,90.33%,97.08%,42656,2.71%,2.92%,"59,915",9010017,7438193,46331
13-Apr,5702,1577526,108599,6.88%,1426145,90.40%,97.09%,42782,2.71%,2.91%,"58,450",9060658,7483132,77522
14-Apr,5656,1583182,108384,6.85%,1431892,90.44%,97.09%,42906,2.71%,2.91%,"58,580",9104844,7521662,74158
15-Apr,6177,1589359,108032,6.80%,1438254,90.49%,97.09%,43073,2.71%,2.91%,"58,328",9153572,7564213,74583
16-Apr,5363,1594722,107297,6.73%,1444229,90.56%,97.10%,43196,2.71%,2.90%,"58,999",9203770,7609048,73406
17-Apr,5041,1599763,106243,6.64%,1450192,90.65%,97.10%,43328,2.71%,2.90%,"60,699",9248725,7648962,64838
18-Apr,4585,1604348,105859,6.60%,1455065,90.70%,97.10%,43424,2.71%,2.90%,"61,694",9280005,7675657,38619
19-Apr,4952,1609300,104319,6.48%,1461414,90.81%,97.11%,43567,2.71%,2.89%,"63,736",9317272,7707972,54728
20-Apr,5549,1614849,102930,6.37%,1468142,90.92%,97.10%,43777,2.71%,2.90%,"63,581",9365379,7750530,69207
21-Apr,5720,1620569,101106,6.24%,1475456,91.05%,97.10%,44007,2.72%,2.90%,"62,411",9412427,7791858,72561
22-Apr,6243,1626812,101191,6.22%,1481449,91.06%,97.10%,44172,2.72%,2.90%,"63,422",9468108,7841296,78593
23-Apr,5436,1632248,100533,6.16%,1487369,91.12%,97.10%,44346,2.72%,2.90%,"65,421",9509667,7877419,63623
24-Apr,4544,1636792,99970,6.11%,1492322,91.17%,97.10%,44500,2.72%,2.90%,"66,377",9551930,7915138,67751
25-Apr,4402,1641194,100474,6.12%,1496126,91.16%,97.11%,44594,2.72%,2.89%,"67,312",9584455,7943261,42719
26-Apr,5944,1647138,100652,6.11%,1501715,91.17%,97.10%,44771,2.72%,2.90%,"68,297",9621322,7974184,51878
27-Apr,4656,1651794,100256,6.07%,1506599,91.21%,97.10%,44939,2.72%,2.90%,"65,911",9673217,8021423,76621
28-Apr,5241,1657035,100502,6.07%,1511417,91.21%,97.10%,45116,2.72%,2.90%,"66,005",9714274,8057239,73283
29-Apr,5833,1662868,100102,6.02%,1517432,91.25%,97.10%,45334,2.73%,2.90%,"66,295",9769757,8106889,75820
30-Apr,5500,1668368,100213,6.01%,1522634,91.26%,97.10%,45521,2.73%,2.90%,"67,208",9821421,8153053,77226
1-May,4512,1672880,100250,5.99%,1526978,91.28%,97.10%,45652,2.73%,2.90%,"69,943",9863143,8190263,63217
2-May,4394,1677274,100760,6.01%,1530718,91.26%,97.10%,45796,2.73%,2.90%,"73,065",9895532,8218258,39958
3-May,4730,1682004,100564,5.98%,1535491,91.29%,97.09%,45949,2.73%,2.91%,"75,355",9931245,8249241,48199
4-May,4369,1686373,99087,5.88%,1541149,91.39%,97.09%,46137,2.74%,2.91%,"77,804",9982781,8296408,75885
5-May,5285,1691658,98217,5.81%,1547092,91.45%,97.09%,46349,2.74%,2.91%,"76,660",10033957,8342299,79318
6-May,5647,1697305,98277,5.79%,1552532,91.47%,97.09%,46496,2.74%,2.91%,"79,957",10084079,8386774,76273
7-May,6327,1703632,98546,5.78%,1558423,91.48%,97.09%,46663,2.74%,2.91%,"82,602",10130714,8427082,75990
8-May,6130,1709762,99003,5.79%,1563917,91.47%,97.09%,46842,2.74%,2.91%,"86,552",10175419,8465657,74547
9-May,3922,1713684,98395,5.74%,1568277,91.51%,97.09%,47012,2.74%,2.91%,"87,892",10205668,8491984,48901
10-May,4891,1718575,96742,5.63%,1574615,91.62%,97.09%,47218,2.75%,2.91%,"89,231",10237631,8519056,49483
11-May,5021,1723596,95924,5.57%,1580207,91.68%,97.08%,47465,2.75%,2.92%,"87,743",10282721,8559125,75416
12-May,4608,1728204,95709,5.54%,1584878,91.71%,97.08%,47617,2.76%,2.92%,"87,034",10321361,8593157,63258
13-May,3448,1731652,94857,5.48%,1589079,91.77%,97.08%,47716,2.76%,2.92%,"87,578",10343074,8611422,31550
14-May,2633,1734285,93576,5.40%,1592886,91.85%,97.09%,47823,2.76%,2.91%,"86,842",10359019,8624734,18540
15-May,2385,1736670,91636,5.28%,1597067,91.96%,97.08%,47967,2.76%,2.92%,"84,326",10381538,8644868,29587
16-May,3080,1739750,90800,5.22%,1600857,92.02%,97.08%,48093,2.76%,2.92%,"81,809",10409178,8669428,37473
17-May,4295,1744045,89129,5.11%,1606611,92.12%,97.08%,48305,2.77%,2.92%,"89,219",10446166,8702121,45653
18-May,4185,1748230,87514,5.01%,1612239,92.22%,97.08%,48477,2.77%,2.92%,"76,827",10489670,8741440,79748
19-May,4871,1753101,87829,5.01%,1616603,92.21%,97.08%,48669,2.78%,2.92%,"73,807",10542828,8789727,84979
20-May,5797,1758898,88439,5.03%,1621572,92.19%,97.07%,48887,2.78%,2.93%,"75,168",10598659,8839761,95435
21-May,5746,1764644,89429,5.07%,1626142,92.15%,97.07%,49073,2.78%,2.93%,"77,431",10670344,8905700,92052
22-May,5296,1769940,91240,5.15%,1629495,92.06%,97.07%,49205,2.78%,2.93%,"77,996",10712109,8942169,81816
23-May,5280,1775220,92847,5.23%,1633045,91.99%,97.07%,49328,2.78%,2.93%,"82,305",10765788,8990568,72958
24-May,5907,1781127,93393,5.24%,1638279,91.98%,97.07%,49455,2.78%,2.93%,"90,465",10820194,9039067,65469
25-May,5060,1786187,94486,5.29%,1642074,91.93%,97.07%,49627,2.78%,2.93%,"92,350",10882055,9095868,84424
26-May,5034,1791221,96187,5.37%,1645263,91.85%,97.06%,49771,2.78%,2.94%,"95,042",10938373,9147152,82320
27-May,6278,1797499,98405,5.47%,1649187,91.75%,97.06%,49907,2.78%,2.94%,"97,733",11000759,9203260,80949
28-May,5862,1803361,98704,5.47%,1654557,91.75%,97.06%,50100,2.78%,2.94%,"103,383",11073851,9270490,110682
29-May,6565,1809926,99690,5.51%,1659974,91.72%,97.06%,50262,2.78%,2.94%,"105,085",11145685,9335759,105946
30-May,6115,1816041,101639,5.60%,1663998,91.63%,97.06%,50404,2.78%,2.94%,"105,518",11197817,9381776,71017
31-May,5662,1821703,102006,5.60%,1669119,91.62%,97.06%,50578,2.78%,2.94%,"56,125",11251308,9429605,67861
1-Jun,4824,1826527,101325,5.55%,1674479,91.68%,97.06%,50723,2.78%,2.94%,"61,108",11302908,9476381,75945
2-Jun,5246,1831773,100364,5.48%,1680501,91.74%,97.06%,50908,2.78%,2.94%,"63,643",11352639,9520866,64830
3-Jun,5353,1837126,94438,5.14%,1691593,92.08%,97.07%,51095,2.78%,2.93%,"70,185",11411006,9573880,95200
4-Jun,6486,1843612,94773,5.14%,1697543,92.08%,97.07%,51296,2.78%,2.93%,"74,774",11476213,9632601,117995
5-Jun,6594,1850206,96973,5.24%,1701784,91.98%,97.07%,51449,2.78%,2.93%,"81,552",11532895,9682689,89025
6-Jun,5832,1856038,98455,5.30%,1705971,91.91%,97.06%,51612,2.78%,2.94%,"85,998",11582225,9726187,64223
7-Jun,6993,1863031,99663,5.35%,1711565,91.87%,97.06%,51803,2.78%,2.94%,"91,269",11633720,9770689,64056
8-Jun,6294,1869325,99963,5.35%,1717370,91.87%,97.06%,51992,2.78%,2.94%,"94,682",11702904,9833579,101931
9-Jun,7725,1877050,101635,5.41%,1723253,91.81%,97.06%,52162,2.78%,2.94%,"97,967",11773437,9896387,107825
10-Jun,8892,1885942,104655,5.55%,1728914,91.67%,97.06%,52373,2.78%,2.94%,"102,824",11842433,9956491,110623
11-Jun,8083,1894025,106315,5.61%,1735144,91.61%,97.06%,52566,2.78%,2.94%,"106,350",11916618,10022593,115772
12-Jun,7465,1901490,108324,5.70%,1740436,91.53%,97.06%,52730,2.77%,2.94%,"106,894",11979782,10078292,97949
13-Jun,9868,1911358,113388,5.93%,1745091,91.30%,97.06%,52879,2.77%,2.94%,"108,997",12028132,10116774,70468
14-Jun,8189,1919547,115197,6.00%,1751234,91.23%,97.06%,53116,2.77%,2.94%,"111,747",12080845,10161298,69314
15-Jun,8161,1927708,116787,6.06%,1757641,91.18%,97.06%,53280,2.76%,2.94%,"108,632",12139998,10212290,108800
16-Jun,9944,1937652,120306,6.21%,1763870,91.03%,97.06%,53476,2.76%,2.94%,"110,660",12182070,10244418,92682
17-Jun,12624,1950276,125303,6.42%,1771220,90.82%,97.05%,53753,2.76%,2.95%,"110,472",12261392,10311116,130829
18-Jun,12990,1963266,130096,6.63%,1779127,90.62%,97.05%,54043,2.75%,2.95%,"111,635",12335197,10371931,132215
19-Jun,12906,1976172,135738,6.87%,1786143,90.38%,97.05%,54291,2.75%,2.95%,"118,023",12410802,10434630,122410
20-Jun,13737,1989909,142719,7.17%,1792528,90.08%,97.04%,54662,2.75%,2.96%,"121,684",12471031,10481122,89183
21-Jun,14536,2004445,147728,7.37%,1801761,89.89%,97.04%,54956,2.74%,2.96%,"124,845",12533392,10528947,84418
22-Jun,13668,2018113,152686,7.57%,1810136,89.69%,97.04%,55291,2.74%,2.96%,"124,918",12604134,10586021,130630
23-Jun,15308,2033421,160524,7.89%,1817303,89.37%,97.03%,55594,2.73%,2.97%,"124,022",12678525,10645104,141187
24-Jun,20574,2053995,171542,8.35%,1826504,88.92%,97.03%,55949,2.72%,2.97%,"126,696",12769028,10715033,136896
25-Jun,18872,2072867,181435,8.75%,1835061,88.53%,97.02%,56371,2.72%,2.98%,"127,422",12864479,10791612,140915
26-Jun,21095,2093962,194776,9.30%,1842457,87.99%,97.01%,56729,2.71%,2.99%,"129,071",12962753,10868791,135634
27-Jun,21342,2115304,207685,9.82%,1850481,87.48%,97.00%,57138,2.70%,3.00%,"129,891",13042286,10926982,98904
28-Jun,20694,2135998,218476,10.23%,1859961,87.08%,97.00%,57561,2.69%,3.00%,"133,130",13122954,10986956,98187
29-Jun,20467,2156465,228835,10.61%,1869606,86.70%,96.99%,58024,2.69%,3.01%,"132,723",13222907,11066442,142641
30-Jun,21807,2178272,239368,10.99%,1880413,86.33%,96.98%,58491,2.69%,3.02%,"130,443",13326172,11147900,142731
1-Jul,24836,2203108,253826,11.52%,1890287,85.80%,96.97%,58995,2.68%,3.03%,"131,329",13424744,11221636,155191
2-Jul,25830,2228938,267539,12.00%,1901865,85.33%,96.96%,59534,2.67%,3.04%,"135,043",13527509,11298571,153608
3-Jul,27913,2256851,281677,12.48%,1915147,84.86%,96.96%,60027,2.66%,3.04%,"133,189",13638492,11381641,157227
4-Jul,27233,2284084,295228,12.93%,1928274,84.42%,96.95%,60582,2.65%,3.05%,"135,120",13724784,11440700,120834
5-Jul,29745,2313829,309999,13.40%,1942690,83.96%,96.95%,61140,2.64%,3.05%,"79,808",13817182,11503353,110115
6-Jul,31189,2345018,324597,13.84%,1958553,83.52%,96.94%,61868,2.64%,3.06%,"86,969",13953947,11608929,183053
7-Jul,34379,2379397,343101,14.42%,1973388,82.94%,96.91%,62908,2.64%,3.09%,"93,407",14095904,11716507,199143
8-Jul,38391,2417788,359455,14.87%,1994573,82.50%,96.90%,63760,2.64%,3.10%,"100,839",14231840,11814052,200361
9-Jul,38124,2455912,367733,14.97%,2023548,82.39%,96.90%,64631,2.63%,3.10%,"118,701",14373845,11917933,219935
10-Jul,35094,2491006,373440,14.99%,2052109,82.38%,96.91%,65457,2.63%,3.09%,"135,378",14519139,12028133,194559
11-Jul,36197,2527203,376015,14.88%,2084724,82.49%,96.91%,66464,2.63%,3.09%,"152,151",14647194,12119991,159219
12-Jul,40427,2567630,380797,14.83%,2119478,82.55%,96.92%,67355,2.62%,3.08%,"170,101",14770511,12202881,149744
13-Jul,47899,2615529,407709,15.59%,2139601,81.80%,96.91%,68219,2.61%,3.09%,"181,043",14929865,12314336,227083
14-Jul,54517,2670046,443473,16.61%,2157363,80.80%,96.89%,69210,2.59%,3.11%,"192,716",15102724,12432678,240724
15-Jul,56757,2726803,480199,17.61%,2176412,79.82%,96.88%,70192,2.57%,3.12%,"209,186",15288045,12561242,249059
16-Jul,54000,2780803,504915,18.16%,2204491,79.28%,96.86%,71397,2.57%,3.14%,"226,551",15467261,12686458,258532
17-Jul,51952,2832755,527872,18.63%,2232394,78.81%,96.85%,72489,2.56%,3.15%,"239,294",15655812,12823057,251392
18-Jul,44721,2877476,542236,18.84%,2261658,78.60%,96.85%,73582,2.56%,3.15%,"253,785",15793858,12916382,192918
19-Jul,34257,2911733,542938,18.65%,2293875,78.78%,96.84%,74920,2.57%,3.16%,"269,455",15921448,13009715,160686
20-Jul,38325,2950058,550192,18.65%,2323666,78.77%,96.82%,76200,2.58%,3.18%,"267,333",16036122,13086064,179275
21-Jul,33772,2983830,549694,18.42%,2356553,78.98%,96.81%,77583,2.60%,3.19%,"271,662",16152354,13168524,153330
22-Jul,49509,3033339,561384,18.51%,2392923,78.89%,96.80%,79032,2.61%,3.20%,"271,667",16381056,13347717,294470
23-Jul,49071,3082410,569901,18.49%,2431911,78.90%,96.79%,80598,2.61%,3.21%,"267,866",16583441,13501031,274246
24-Jul,45416,3127826,574135,18.36%,2471678,79.02%,96.79%,82013,2.62%,3.21%,"264,578",16763394,13635568,252696
25-Jul,38679,3166505,573908,18.12%,2509318,79.25%,96.79%,83279,2.63%,3.21%,"275,145",16887533,13721028,173472
26-Jul,28228,3194733,560275,17.54%,2549692,79.81%,96.78%,84766,2.65%,3.22%,"287,987",17008799,13814066,160589
27-Jul,45203,3239936,556281,17.17%,2596820,80.15%,96.76%,86835,2.68%,3.24%,"281,492",17189001,13949065,270434
28-Jul,47791,3287727,558392,16.98%,2640676,80.32%,96.75%,88659,2.70%,3.25%,"271,132",17374182,14086455,277809
29-Jul,43479,3331206,554484,16.65%,2686170,80.64%,96.74%,90552,2.72%,3.26%,"274,157",17547646,14216440,262954
30-Jul,41168,3372374,549343,16.29%,2730720,80.97%,96.73%,92311,2.74%,3.27%,"278,546",17712645,14340271,252184
31-Jul,37284,3409658,545447,16.00%,2770092,81.24%,96.71%,94119,2.76%,3.29%,"278,618",17862867,14453209,241761
1-Aug,30738,3440396,535135,15.55%,2809538,81.66%,96.71%,95723,2.78%,3.29%,"280,518",17975528,14535132,178679
2-Aug,22404,3462800,523164,15.11%,2842345,82.08%,96.69%,97291,2.81%,3.31%,"109,374",18082313,14619513,151216
3-Aug,33900,3496700,524142,14.99%,2873669,82.18%,96.67%,98889,2.83%,3.33%,"130,628",18234025,14737325,247926
4-Aug,35867,3532567,524011,14.83%,2907920,82.32%,96.66%,100636,2.85%,3.34%,"146,820",18382837,14850270,242328
5-Aug,35764,3568331,518310,14.53%,2947646,82.61%,96.64%,102375,2.87%,3.36%,"172,063",18536754,14968423,248556
6-Aug,39532,3607863,507375,14.06%,2996478,83.05%,96.65%,104010,2.88%,3.35%,"196,829",18685734,15077871,237556
7-Aug,31753,3639616,497824,13.68%,3036194,83.42%,96.64%,105598,2.90%,3.36%,"218,183",18829789,15190173,235787
8-Aug,26415,3666031,474233,12.94%,3084702,84.14%,96.64%,107096,2.92%,3.36%,"238,649",18932354,15266323,166944
9-Aug,20709,3686740,448508,12.17%,3129661,84.89%,96.65%,108571,2.94%,3.35%,"256,748",19031741,15345001,145202
10-Aug,32081,3718821,437055,11.75%,3171147,85.27%,96.63%,110619,2.97%,3.37%,"273,575",19177891,15459070,241152
11-Aug,30625,3749446,426170,11.37%,3211078,85.64%,96.62%,112198,2.99%,3.38%,"286,417",19313350,15563904,210815
12-Aug,24709,3774155,412776,10.94%,3247715,86.05%,96.62%,113664,3.01%,3.38%,"302,070",19449602,15675447,153717
13-Aug,30788,3804943,400129,10.52%,3289718,86.46%,96.62%,115096,3.02%,3.38%,"308,852",19596083,15791140,226031
14-Aug,28598,3833541,395577,10.32%,3321598,86.65%,96.62%,116366,3.04%,3.38%,"302,433",19722499,15888958,222582
15-Aug,20813,3854354,384807,9.98%,3351959,86.97%,96.61%,117588,3.05%,3.39%,"300,912",19812267,15957913,159178
16-Aug,17384,3871738,371021,9.58%,3381884,87.35%,96.61%,118833,3.07%,3.39%,"306,164",19890644,16018906,129010
17-Aug,20741,3892479,358357,9.21%,3414109,87.71%,96.60%,120013,3.08%,3.40%,"293,179",19992070,16099591,182216
18-Aug,15768,3908247,343203,8.78%,3443903,88.12%,96.60%,121141,3.10%,3.40%,"282,964",20070696,16162449,137182
19-Aug,22053,3930300,334752,8.52%,3472915,88.36%,96.59%,122633,3.12%,3.41%,"275,810",20185804,16255504,214410
20-Aug,20004,3950304,327286,8.29%,3499037,88.58%,96.58%,123981,3.14%,3.42%,"269,480",20299651,16349347,202484
21-Aug,16744,3967048,319658,8.06%,3522048,88.78%,96.56%,125342,3.16%,3.44%,"268,065",20415957,16448909,200250
22-Aug,12408,3979456,306760,7.71%,3546324,89.12%,96.56%,126372,3.18%,3.44%,"262,664",20501173,16521717,148410
23-Aug,9604,3989060,290764,7.29%,3571082,89.52%,96.56%,127214,3.19%,3.44%,"268,947",20575497,16586437,122737
24-Aug,19106,4008166,273750,6.83%,3606164,89.97%,96.57%,128252,3.20%,3.43%,"260,434",20699341,16691175,185852
25-Aug,18671,4026837,257677,6.40%,3639867,90.39%,96.57%,129293,3.21%,3.43%,"258,191",20846129,16819292,249265
26-Aug,16899,4043736,243588,6.02%,3669966,90.76%,96.57%,130182,3.22%,3.43%,"255,969",20974752,16931016,205774
27-Aug,12618,4056354,236317,5.83%,3689256,90.95%,96.58%,130781,3.22%,3.42%,"250,014",21082273,17025919,184115
28-Aug,10050,4066404,227182,5.59%,3707850,91.18%,96.58%,131372,3.23%,3.42%,"248,139",21186587,17120183,181674
29-Aug,7427,4073831,217590,5.34%,3724318,91.42%,96.58%,131923,3.24%,3.42%,"249,836",21279118,17205287,154160
30-Aug,5436,4079267,203060,4.98%,3743716,91.77%,96.58%,132491,3.25%,3.42%,"251,951",21357173,17277906,125423
31-Aug,10534,4089801,196281,4.80%,3760497,91.95%,96.58%,133023,3.25%,3.42%,"248,333",21487697,17397896,224242
1-Sep,10337,4100138,189571,4.62%,3776891,92.12%,96.58%,133676,3.26%,3.42%,"251,359",21621776,17521638,220061
2-Sep,8955,4109093,176638,4.30%,3798099,92.43%,96.58%,134356,3.27%,3.42%,"252,017",21750629,17641536,208715
3-Sep,7797,4116890,168317,4.09%,3813643,92.63%,96.58%,134930,3.28%,3.42%,"256,777",21878972,17762082,209289
4-Sep,6727,4123617,160699,3.90%,3827449,92.82%,96.58%,135469,3.29%,3.42%,"259,426",22007274,17883657,210431
5-Sep,5403,4129020,155519,3.77%,3837640,92.94%,96.58%,135861,3.29%,3.42%,"264,081",22112218,17983198,171885
6-Sep,4413,4133433,146271,3.54%,3850689,93.16%,96.58%,136473,3.30%,3.42%,"108,666",22208725,18075292,152942
7-Sep,7201,4140634,138630,3.35%,3864848,93.34%,96.57%,137156,3.31%,3.43%,"127,465",22367690,18227056,251639
8-Sep,6731,4147365,132823,3.20%,3876760,93.48%,96.57%,137782,3.32%,3.43%,"150,134",22513350,18365985,232302
9-Sep,5990,4153355,127829,3.08%,3887410,93.60%,96.57%,138116,3.33%,3.43%,"180,998",22661808,18508453,231278
10-Sep,5376,4158731,118534,2.85%,3901766,93.82%,96.57%,138431,3.33%,3.43%,"209,579",22811588,18652857,235681
11-Sep,5001,4163732,115679,2.78%,3909352,93.89%,96.57%,138701,3.33%,3.43%,"229,927",22954723,18790991,231570
12-Sep,3779,4167511,109869,2.64%,3918753,94.03%,96.58%,138889,3.33%,3.42%,"258,210",23078739,18911228,198052
13-Sep,2577,4170088,99696,2.39%,3931227,94.27%,96.58%,139165,3.34%,3.42%,"286,170",23199268,19029180,177234
14-Sep,4128,4174216,92328,2.21%,3942473,94.45%,96.58%,139415,3.34%,3.42%,"304,706",23384990,19210774,278680
15-Sep,3948,4178164,84963,2.03%,3953519,94.62%,96.59%,139682,3.34%,3.41%,"333,326",23538483,19360319,232441
16-Sep,3145,4181309,73238,1.75%,3968152,94.90%,96.59%,139919,3.35%,3.41%,"354,479",23593249,19411940,243711
17-Sep,3835,4185144,68942,1.65%,3976064,95.00%,96.60%,140138,3.35%,3.40%,"234,397",23886703,19701559,243711
18-Sep,3385,4188529,65066,1.55%,3983140,95.10%,96.60%,140323,3.35%,3.40%,"364,144",24087841,19899312,276094
19-Sep,2234,4190763,60969,1.45%,3989326,95.19%,96.60%,140468,3.35%,3.40%,"234,824",24221606,20030843,192413
20-Sep,1932,4192695,55936,1.33%,3996125,95.31%,96.60%,140634,3.35%,3.40%,"346,285",24372320,20179625,202795
21-Sep,3263,4195958,52447,1.25%,4002706,95.39%,96.60%,140805,3.36%,3.40%,"393,404",24548760,20352802,248657
22-Sep,2720,4198678,49662,1.18%,4008062,95.46%,96.60%,140954,3.36%,3.40%,"373,201",24734156,20535478,256163
23-Sep,2881,4201559,47957,1.14%,4012488,95.50%,96.60%,141114,3.36%,3.40%,"353,860",24908070,20706511,248125
24-Sep,2557,4204116,45803,1.09%,4017055,95.55%,96.60%,141258,3.36%,3.40%,"370,614",25081043,20876927,252596
25-Sep,2137,4206253,44071,1.05%,4020801,95.59%,96.60%,141381,3.36%,3.40%,"375,061",25262904,21056651,257803
26-Sep,1760,4208013,42769,1.02%,4023777,95.62%,96.60%,141467,3.36%,3.40%,"380,082",25411647,21203634,217084
27-Sep,1390,4209403,40270,0.96%,4027548,95.68%,96.60%,141585,3.36%,3.40%,"388,341",25563613,21354210,214591
28-Sep,2057,4211460,38652,0.92%,4031099,95.72%,96.60%,141709,3.36%,3.40%,"381,253",25757117,21545657,275768
29-Sep,1954,4213414,37412,0.89%,4034176,95.75%,96.60%,141826,3.37%,3.40%,"378,922",25954487,21741073,278567
30-Sep,1690,4215104,36141,0.86%,4037024,95.78%,96.60%,141939,3.37%,3.40%,"384,228",26148296,21933192,276135
1-Oct,1624,4216728,34867,0.83%,4039835,95.80%,96.60%,142026,3.37%,3.40%,"384,552",26319442,22102714,251368
2-Oct,1414,4218142,33812,0.80%,4042215,95.83%,96.60%,142115,3.37%,3.40%,"381,124",26479441,22261299,236653
3-Oct,1142,4219284,32876,0.78%,4044235,95.85%,96.60%,142173,3.37%,3.40%,"388,368",26640081,22420797,238058
4-Oct,922,4220206,31054,0.74%,4046891,95.89%,96.60%,142261,3.37%,3.40%,"108,264",26786789,22566583,211514
5-Oct,1404,4221610,29823,0.71%,4049449,95.92%,96.60%,142338,3.37%,3.40%,"139,156",26963512,22741902,255486
6-Oct,1484,4223094,28381,0.67%,4052300,95.96%,96.60%,142413,3.37%,3.40%,"170,894",27153742,22930648,274439
7-Oct,1393,4224487,27747,0.66%,4054246,95.97%,96.60%,142494,3.37%,3.40%,"213,616",27334864,23110377,259555
8-Oct,1384,4225871,25551,0.60%,4057760,96.02%,96.61%,142560,3.37%,3.39%,"253,067",27516374,23290503,268146
9-Oct,1167,4227038,25159,0.60%,4059267,96.03%,96.61%,142612,3.37%,3.39%,"292,253",27699284,23472246,267050
10-Oct,894,4227932,24430,0.58%,4060851,96.05%,96.61%,142651,3.37%,3.39%,"331,377",27843954,23616022,219649
11-Oct,620,4228552,22541,0.53%,4063295,96.09%,96.61%,142716,3.38%,3.39%,"368,489",27995294,23766742,225083
12-Oct,1261,4229813,21625,0.51%,4065425,96.11%,96.61%,142763,3.38%,3.39%,"396,064",28186327,23956514,276363
13-Oct,1233,4231046,20551,0.49%,4067684,96.14%,96.61%,142811,3.38%,3.39%,"424,799",28367503,24136457,261731
14-Oct,1053,4232099,19852,0.47%,4069399,96.16%,96.61%,142848,3.38%,3.39%,,28533210,24301111,258945
15-Oct,915,4233014,19318,0.46%,4070807,96.17%,96.61%,142889,3.38%,3.39%,,28713630,24480616,267338
16-Oct,997,4234011,18746,0.44%,4072332,96.18%,96.61%,142933,3.38%,3.39%,,28893860,24659849,270811
17-Oct,747,4234758,18388,0.43%,4073418,96.19%,96.61%,142952,3.38%,3.39%,,29040820,24806062,223929
18-Oct,626,4235384,17374,0.41%,4075011,96.21%,96.61%,142999,3.38%,3.39%,,29186549,24951165,215213
19-Oct,903,4236287,16697,0.39%,4076541,96.23%,96.61%,143049,3.38%,3.39%,,29362005,25125718,260343
20-Oct,914,4237201,16376,0.39%,4077748,96.24%,96.61%,143077,3.38%,3.39%,,29518351,25281150,248113
21-Oct,633,4237834,15594,0.37%,4079120,96.25%,96.61%,143120,3.38%,3.39%,,29666843,25429009,218399
22-Oct,760,4238594,15090,0.36%,4080351,96.27%,96.61%,143153,3.38%,3.39%,,29832090,25593496,250740
23-Oct,802,4239396,14803,0.35%,4081417,96.27%,96.61%,143176,3.38%,3.39%,,29993954,25754558,250587
24-Oct,623,4240019,14360,0.34%,4082454,96.28%,96.61%,143205,3.38%,3.39%,,30128236,25888217,214745
25-Oct,460,4240479,13554,0.32%,4083690,96.30%,96.61%,143235,3.38%,3.39%,,30265853,26025374,215822
26-Oct,611,4241090,12989,0.31%,4084831,96.32%,96.61%,143270,3.38%,3.39%,,30443930,26202840,259064
27-Oct,719,4241809,12735,0.30%,4085775,96.32%,96.61%,143299,3.38%,3.39%,,30627749,26385940,260451
28-Oct,723,4242532,12440,0.29%,4086759,96.33%,96.61%,143333,3.38%,3.39%,,30791978,26549446,259541
29-Oct,683,4243215,12414,0.29%,4087440,96.33%,96.61%,143361,3.38%,3.39%,,30952719,26709504,244392
30-Oct,620,4243835,12309,0.29%,4088138,96.33%,96.61%,143388,3.38%,3.39%,,31109059,26865224,239386
31-Oct,523,4244358,12318,0.29%,4088635,96.33%,96.61%,143405,3.38%,3.39%,,31236013,26991655,202073
1-Nov,403,4244761,11919,0.28%,4089419,96.34%,96.61%,143423,3.38%,3.39%,,31373386,27128625,203816
2-Nov,612,4245373,11629,0.27%,4090287,96.35%,96.61%,143457,3.38%,3.39%,,31548810,27303437,255294
3-Nov,801,4246174,11592,0.27%,4091101,96.35%,96.61%,143481,3.38%,3.39%,,31716481,27470307,253393
4-Nov,628,4246802,11364,0.27%,4091938,96.35%,96.61%,143500,3.38%,3.39%,,31900688,27653886,249240
